21 22 4 5 5 5 5 5 5 5 5 5 5 6 20 21 21 22 0 0 0 0 0 0 0 0 0 0 0 0 0 0 0 0 0 0 
21 22 16 19 19 19 19 19 19 19 19 19 19 18 20 21 21 22 0 0 0 0 0 0 0 0 0 0 0 0 0 0 0 0 0 0 
21 22 37 37 37 37 37 37 37 37 37 37 37 38 20 21 21 22 0 0 0 0 0 0 0 0 0 0 0 0 0 0 0 0 0 0 
21 22 37 37 37 37 1 2 3 37 37 37 37 38 20 21 21 22 0 0 0 0 0 0 0 0 0 0 0 0 0 0 0 0 0 0 
21 22 37 37 37 37 13 14 15 37 37 37 37 38 20 21 21 22 0 0 0 0 0 0 0 0 0 0 0 0 0 0 0 0 0 0 
21 22 37 37 37 37 25 26 27 37 37 37 37 38 20 21 21 22 0 0 0 0 0 0 0 0 0 0 0 0 0 0 0 0 0 0 
21 22 37 37 37 37 37 37 37 37 37 37 37 38 20 21 21 22 0 0 0 0 0 0 0 0 0 0 0 0 0 0 0 0 0 0 
21 22 37 37 37 37 37 37 37 37 37 37 37 38 20 21 21 22 0 0 0 0 0 0 0 0 0 0 0 0 0 0 0 0 0 0 
21 22 37 37 37 37 37 37 37 37 37 37 37 38 20 21 21 22 0 0 0 0 0 0 0 0 0 0 0 0 0 0 0 0 0 0 
21 22 37 37 37 37 37 37 37 37 37 37 37 38 20 21 21 22 0 0 0 0 0 0 0 0 0 0 0 0 0 0 0 0 0 0 
21 22 37 37 37 37 37 37 37 37 37 37 37 38 20 21 21 22 0 0 0 0 0 0 0 0 0 0 0 0 0 0 0 0 0 0 
21 22 37 37 37 37 37 37 37 37 37 37 37 38 20 21 21 22 0 0 0 0 0 0 0 0 0 0 0 0 0 0 0 0 0 0 
21 22 37 37 37 37 8 9 9 9 9 9 9 9 45 21 21 22 0 0 0 0 0 0 0 0 0 0 0 0 0 0 0 0 0 0 
21 22 37 37 37 37 20 21 21 21 21 21 21 21 21 21 21 22 0 0 0 0 0 0 0 0 0 0 0 0 0 0 0 0 0 0 
21 22 37 37 37 38 20 21 21 21 21 21 21 21 21 21 21 22 0 0 0 0 0 0 0 0 0 0 0 0 0 0 0 0 0 0 
21 22 37 37 37 38 32 33 33 33 33 33 33 33 57 21 21 22 0 0 0 0 0 0 0 0 0 0 0 0 0 0 0 0 0 0 
21 22 37 37 37 38 5 5 5 5 5 5 5 5 20 21 21 22 0 0 0 0 0 0 0 0 0 0 0 0 0 0 0 0 0 0 
21 22 37 37 37 38 16 17 17 17 17 17 17 18 20 21 21 22 0 0 0 0 0 0 0 0 0 0 0 0 0 0 0 0 0 0 
21 22 37 37 37 37 37 37 37 37 37 37 37 38 20 21 21 22 0 0 0 0 0 0 0 0 0 0 0 0 0 0 0 0 0 0 
21 22 37 37 37 37 37 37 37 37 37 37 37 38 20 21 21 22 0 0 0 0 0 0 0 0 0 0 0 0 0 0 0 0 0 0 
21 46 9 9 9 9 9 9 9 10 37 37 37 38 20 21 21 22 0 0 0 0 0 0 0 0 0 0 0 0 0 0 0 0 0 0 
21 21 21 21 21 21 21 21 21 22 37 37 37 38 20 21 21 22 0 0 0 0 0 0 0 0 0 0 0 0 0 0 0 0 0 0 
21 21 21 21 21 21 21 21 21 22 37 37 37 38 20 21 21 22 0 0 0 0 0 0 0 0 0 0 0 0 0 0 0 0 0 0 
21 58 33 33 33 33 33 33 33 34 37 37 37 38 20 21 21 22 0 0 0 0 0 0 0 0 0 0 0 0 0 0 0 0 0 0 
21 22 5 5 5 5 5 5 5 5 37 37 37 38 20 21 21 22 0 0 0 0 0 0 0 0 0 0 0 0 0 0 0 0 0 0 
21 22 16 17 17 17 17 17 17 16 37 37 37 38 20 21 21 22 0 0 0 0 0 0 0 0 0 0 0 0 0 0 0 0 0 0 
21 22 37 37 37 37 37 37 37 37 37 37 37 38 20 21 21 22 0 0 0 0 0 0 0 0 0 0 0 0 0 0 0 0 0 0 
21 22 37 37 37 37 37 37 37 37 37 37 37 38 20 21 21 22 0 0 0 0 0 0 0 0 0 0 0 0 0 0 0 0 0 0 
21 22 37 37 37 37 8 9 9 9 9 9 9 9 45 21 21 22 0 0 0 0 0 0 0 0 0 0 0 0 0 0 0 0 0 0 
21 22 37 37 37 37 20 21 21 21 21 21 21 21 21 21 21 22 0 0 0 0 0 0 0 0 0 0 0 0 0 0 0 0 0 0 
21 22 37 37 37 38 20 21 21 21 21 21 21 21 21 21 21 22 0 0 0 0 0 0 0 0 0 0 0 0 0 0 0 0 0 0 
21 22 37 37 37 38 32 33 33 33 33 33 33 33 57 21 21 22 0 0 0 0 0 0 0 0 0 0 0 0 0 0 0 0 0 0 
21 22 37 37 37 38 5 5 5 5 5 5 5 5 20 21 21 22 0 0 0 0 0 0 0 0 0 0 0 0 0 0 0 0 0 0 
21 22 37 37 37 38 16 17 17 17 17 17 17 18 20 21 21 22 0 0 0 0 0 0 0 0 0 0 0 0 0 0 0 0 0 0 
21 22 37 37 37 37 37 37 37 37 37 37 37 38 20 21 21 22 0 0 0 0 0 0 0 0 0 0 0 0 0 0 0 0 0 0 
21 22 37 37 37 37 37 37 37 37 37 37 37 38 20 21 21 22 0 0 0 0 0 0 0 0 0 0 0 0 0 0 0 0 0 0 
21 22 39 39 39 39 39 39 37 37 39 39 39 39 20 21 21 22 0 0 0 0 0 0 0 0 0 0 0 0 0 0 0 0 0 0 
21 22 39 39 39 39 39 39 37 37 39 39 39 39 20 21 21 22 0 0 0 0 0 0 0 0 0 0 0 0 0 0 0 0 0 0 
21 22 39 39 37 37 37 37 37 37 39 39 39 39 20 21 21 22 0 0 0 0 0 0 0 0 0 0 0 0 0 0 0 0 0 0 
21 22 39 39 37 37 37 37 37 37 39 39 39 39 20 21 21 22 0 0 0 0 0 0 0 0 0 0 0 0 0 0 0 0 0 0 
21 22 39 39 37 37 39 39 39 39 39 39 39 39 20 21 21 22 0 0 0 0 0 0 0 0 0 0 0 0 0 0 0 0 0 0 
21 22 39 39 37 37 39 39 39 39 39 39 39 39 20 21 21 22 0 0 0 0 0 0 0 0 0 0 0 0 0 0 0 0 0 0 
21 22 37 37 37 37 37 37 37 37 37 37 37 38 20 21 21 22 0 0 0 0 0 0 0 0 0 0 0 0 0 0 0 0 0 0 
21 22 37 37 37 37 37 37 37 37 37 37 37 38 20 21 21 22 0 0 0 0 0 0 0 0 0 0 0 0 0 0 0 0 0 0 
21 22 9 9 9 10 37 37 37 37 8 9 9 9 45 21 21 22 0 0 0 0 0 0 0 0 0 0 0 0 0 0 0 0 0 0 
21 22 21 21 21 22 37 37 37 37 20 21 21 21 21 21 21 22 0 0 0 0 0 0 0 0 0 0 0 0 0 0 0 0 0 0 
21 22 21 21 21 22 37 37 37 38 20 21 21 21 21 21 21 22 0 0 0 0 0 0 0 0 0 0 0 0 0 0 0 0 0 0 
21 22 33 33 33 34 37 37 37 38 32 33 33 33 57 21 21 22 0 0 0 0 0 0 0 0 0 0 0 0 0 0 0 0 0 0 
21 22 5 5 5 5 37 37 37 38 5 5 5 5 20 21 21 22 0 0 0 0 0 0 0 0 0 0 0 0 0 0 0 0 0 0 
21 22 17 17 17 16 37 37 37 38 16 17 17 17 20 21 21 22 0 0 0 0 0 0 0 0 0 0 0 0 0 0 0 0 0 0 
21 22 37 37 37 37 37 37 37 37 37 37 37 38 20 21 21 22 0 0 0 0 0 0 0 0 0 0 0 0 0 0 0 0 0 0 
21 22 37 37 37 37 37 37 37 37 37 37 37 38 20 21 21 22 0 0 0 0 0 0 0 0 0 0 0 0 0 0 0 0 0 0 
21 22 37 37 37 37 37 37 37 37 39 39 39 39 20 21 21 22 0 0 0 0 0 0 0 0 0 0 0 0 0 0 0 0 0 0 
21 22 37 37 37 37 37 37 37 37 39 39 39 39 20 21 21 22 0 0 0 0 0 0 0 0 0 0 0 0 0 0 0 0 0 0 
21 22 39 39 37 37 39 39 37 37 39 39 37 38 20 21 21 22 0 0 0 0 0 0 0 0 0 0 0 0 0 0 0 0 0 0 
21 22 39 39 37 37 39 39 37 37 39 39 37 38 20 21 21 22 0 0 0 0 0 0 0 0 0 0 0 0 0 0 0 0 0 0 
21 22 37 37 37 37 39 39 39 39 39 39 37 38 20 21 21 22 0 0 0 0 0 0 0 0 0 0 0 0 0 0 0 0 0 0 
21 22 37 37 37 37 39 39 39 39 39 39 37 38 20 21 21 22 0 0 0 0 0 0 0 0 0 0 0 0 0 0 0 0 0 0 
21 22 37 37 37 37 37 37 37 37 37 37 37 38 20 21 21 22 0 0 0 0 0 0 0 0 0 0 0 0 0 0 0 0 0 0 
21 22 37 37 37 37 37 37 37 37 37 37 37 38 20 21 21 22 0 0 0 0 0 0 0 0 0 0 0 0 0 0 0 0 0 0 
21 22 9 9 9 9 9 9 9 10 37 37 37 38 20 21 21 22 0 0 0 0 0 0 0 0 0 0 0 0 0 0 0 0 0 0 
21 22 21 21 21 21 21 21 21 22 37 37 37 38 20 21 21 46 9 9 9 9 9 9 9 9 9 9 9 9 9 9 9 9 9 9 
21 22 21 21 21 21 21 21 21 22 37 37 37 38 20 21 21 21 21 21 21 21 21 21 21 21 21 21 21 21 21 21 21 21 21 21 
21 22 33 33 33 33 33 33 33 34 37 37 37 38 20 21 21 21 21 21 21 21 21 21 21 21 21 21 21 21 21 21 21 21 21 21 
21 22 5 5 5 5 5 5 5 5 37 37 37 38 20 21 21 58 33 33 33 33 33 33 33 33 33 33 33 33 57 21 21 21 21 21 
21 22 16 17 17 17 17 17 17 16 37 37 37 38 20 21 21 22 4 5 5 5 5 5 5 5 5 5 5 6 20 21 21 21 21 21 
21 22 37 37 37 37 37 37 37 37 37 37 37 38 20 21 21 22 4 5 5 5 5 5 5 5 5 5 5 6 20 21 21 21 21 21 
21 22 37 37 37 37 37 37 37 37 37 37 37 38 20 21 21 22 37 37 37 37 37 37 37 37 37 37 37 37 20 21 21 21 21 21 
21 22 37 37 37 37 39 39 37 37 37 37 37 38 20 21 21 22 37 37 37 37 37 37 37 37 37 37 37 37 20 21 21 21 21 21 
21 22 37 37 37 37 39 39 37 37 37 37 37 38 20 21 21 22 37 37 37 37 37 37 37 37 37 37 37 37 20 21 21 21 21 21 
21 22 37 37 39 39 39 39 39 39 37 37 39 39 20 21 21 22 37 37 37 37 37 37 37 37 37 37 37 37 20 21 21 21 21 21 
21 22 37 37 39 39 39 39 39 39 37 37 39 39 20 21 21 22 37 37 37 37 37 37 37 37 37 37 37 37 20 21 21 21 21 21 
21 22 37 37 37 37 39 39 37 37 37 37 37 38 20 21 21 22 37 37 37 37 37 37 37 37 37 37 37 37 20 21 21 21 21 21 
21 22 37 37 37 37 39 39 37 37 37 37 37 38 20 21 21 22 37 37 37 37 37 37 37 37 37 37 37 37 20 21 21 21 21 21 
21 22 37 37 37 37 37 37 37 37 37 37 37 38 20 21 21 22 37 37 37 37 37 37 37 37 37 37 37 37 20 21 21 21 21 21 
21 22 37 37 37 37 37 37 37 37 37 37 37 38 20 21 21 22 37 37 37 37 37 37 37 37 37 37 37 37 20 21 21 21 21 21 
21 22 37 37 37 37 8 9 9 9 9 9 9 9 45 21 21 22 37 37 37 37 37 37 37 37 37 37 37 37 20 21 21 21 21 21 
21 22 37 37 37 37 20 21 21 21 21 21 21 21 21 21 21 46 9 9 9 9 10 11 12 8 9 9 9 9 45 21 21 21 21 21 
21 22 37 37 37 38 20 21 21 21 21 21 21 21 21 21 21 21 21 21 21 21 22 23 24 20 21 21 21 21 21 21 21 21 21 21 
21 22 37 37 37 38 32 33 33 33 33 33 33 33 57 21 21 21 21 21 21 21 22 35 36 20 21 21 21 21 21 21 21 21 21 21 
21 22 37 37 37 38 5 5 5 5 5 5 5 5 20 21 21 58 33 33 33 33 34 47 48 32 33 33 33 33 57 21 21 21 21 21 
21 22 37 37 37 38 16 17 17 17 17 17 17 18 20 21 21 22 16 17 17 17 17 59 60 16 17 17 17 18 20 21 21 21 21 21 
21 22 37 37 37 37 37 37 37 37 37 37 37 38 20 21 21 22 39 39 39 39 37 37 37 37 37 37 37 38 20 21 21 21 21 21 
21 22 37 37 37 37 37 37 37 37 37 37 37 38 20 21 21 22 39 39 39 39 37 37 37 37 37 37 37 38 20 21 21 21 21 21 
21 22 37 37 37 37 37 37 37 37 37 37 37 38 20 21 21 22 39 39 39 39 39 39 37 37 37 37 37 38 20 21 21 21 21 21 
21 22 37 37 37 37 37 37 37 37 37 37 37 38 20 21 21 22 39 39 39 39 39 39 37 37 37 37 37 38 20 21 21 21 21 21 
21 22 37 37 37 37 37 37 37 37 37 37 37 38 20 21 21 22 39 39 39 39 39 39 39 39 39 37 37 38 20 21 21 21 21 21 
21 22 37 37 37 37 37 37 37 37 37 37 37 38 20 21 21 22 39 39 39 39 39 39 39 39 39 37 37 38 20 21 21 21 21 21 
21 22 37 37 37 37 37 37 37 37 37 37 37 38 20 21 21 22 70 70 70 70 70 70 70 70 70 70 70 70 20 21 21 21 21 21 
21 22 37 37 37 37 37 37 37 37 37 37 37 38 20 21 21 22 70 70 70 70 70 70 70 70 70 70 70 70 20 21 21 21 21 21 
21 22 37 37 37 37 37 37 37 37 37 37 37 38 20 21 21 22 39 39 37 37 39 39 37 37 39 39 37 38 20 21 21 21 21 21 
21 22 37 37 37 37 37 37 37 37 37 37 37 38 20 21 21 22 39 39 37 37 39 39 37 37 39 39 37 38 20 21 21 21 21 21 
21 22 9 9 9 9 9 9 9 10 37 37 37 38 20 21 21 22 70 70 70 70 70 70 70 70 70 70 70 70 20 21 21 21 21 21 
21 22 21 21 21 21 21 21 21 22 37 37 37 38 20 21 21 22 70 70 70 70 70 70 70 70 70 70 70 70 20 21 21 21 21 21 
21 22 21 21 21 21 21 21 21 22 37 37 37 38 20 21 21 22 37 37 39 39 37 37 39 39 37 37 39 39 20 21 21 21 21 21 
21 22 33 33 33 33 33 33 33 34 37 37 37 38 20 21 21 22 37 37 39 39 37 37 39 39 37 37 39 39 20 21 21 21 21 21 
21 22 5 5 5 5 5 5 5 5 37 37 37 38 20 21 21 22 70 70 70 70 70 70 70 70 70 70 70 70 20 21 21 21 21 21 
21 22 16 17 17 17 17 17 17 16 37 37 37 38 20 21 21 22 70 70 70 70 70 70 70 70 70 70 70 70 20 21 21 21 21 21 
21 22 37 37 37 37 37 37 37 37 37 37 37 38 20 21 21 22 39 39 37 37 39 39 37 37 39 39 37 38 20 21 21 21 21 21 
21 22 37 37 37 37 37 37 37 37 37 37 37 38 20 21 21 22 39 39 37 37 39 39 37 37 39 39 37 38 20 21 21 21 21 21 
21 22 37 37 37 37 8 9 9 9 9 9 9 9 45 21 21 22 70 70 70 70 70 70 70 70 70 70 70 70 20 21 21 21 21 21 
21 22 37 37 37 37 20 21 21 21 21 21 21 21 21 21 21 22 70 70 70 70 70 70 70 70 70 70 70 70 20 21 21 21 21 21 
21 22 37 37 37 38 20 21 21 21 21 21 21 21 21 21 21 22 37 37 39 39 37 37 39 39 37 37 39 39 20 21 21 21 21 21 
21 22 37 37 37 38 32 33 33 33 33 33 33 33 57 21 21 22 37 37 39 39 37 37 39 39 37 37 39 39 20 21 21 21 21 21 
21 22 37 37 37 38 5 5 5 5 5 5 5 5 20 21 21 22 70 70 70 70 70 70 70 70 70 70 70 70 20 21 21 21 21 21 
21 22 37 37 37 38 16 17 17 17 17 17 17 18 20 21 21 22 70 70 70 70 70 70 70 70 70 70 70 70 20 21 21 21 21 21 
21 22 37 37 37 37 37 37 37 37 37 37 37 38 20 21 21 22 37 37 37 37 37 37 37 37 37 37 37 38 20 21 21 21 21 21 
21 22 37 37 37 37 37 37 37 37 37 37 37 38 20 21 21 22 37 37 37 37 37 37 37 37 37 37 37 38 20 21 21 21 21 21 
21 46 9 9 9 9 10 11 12 8 9 9 9 9 45 21 21 46 9 9 9 9 10 11 12 8 9 9 9 9 45 21 21 21 21 21 
21 21 21 21 21 21 22 23 24 20 21 21 21 21 21 21 21 21 21 21 21 21 22 23 24 20 21 21 21 21 21 21 21 21 21 21 
21 21 21 21 21 21 22 35 36 20 21 21 21 21 21 21 21 21 21 21 21 21 22 35 36 20 21 21 21 21 21 21 21 21 21 21 
21 58 33 33 33 33 34 47 48 32 33 33 33 33 57 21 21 58 33 33 33 33 34 47 48 32 33 33 33 33 57 21 21 21 21 21 
21 22 16 17 17 17 17 59 60 16 17 17 17 18 20 21 21 22 16 17 17 17 17 59 60 16 17 17 17 18 20 21 21 21 21 21 
21 22 37 37 39 39 37 71 72 37 39 39 37 38 20 21 21 22 37 37 39 39 37 71 72 37 39 39 37 38 20 21 21 21 21 21 
21 22 37 37 39 39 37 37 37 37 39 39 37 38 20 21 21 22 37 37 39 39 37 37 37 37 39 39 37 38 20 21 21 21 21 21 
21 22 37 37 39 39 37 37 37 37 39 39 37 38 20 21 21 22 37 37 39 39 37 37 37 37 37 37 37 38 20 21 21 21 21 21 
21 22 37 37 39 39 37 37 37 37 39 39 37 38 20 21 21 22 37 37 39 39 37 37 37 37 37 37 37 38 20 21 21 21 21 21 
21 22 37 37 39 39 39 37 37 39 39 39 37 38 20 21 21 22 37 37 39 39 39 39 39 39 39 39 37 38 20 21 21 21 21 21 
21 22 37 37 39 39 39 37 37 39 39 39 37 38 20 21 21 22 37 37 39 39 39 39 39 39 39 39 37 38 20 21 21 21 21 21 
21 22 37 37 37 37 37 37 37 37 37 37 37 38 4 5 5 5 37 37 37 37 37 37 37 37 37 37 37 38 20 21 21 21 21 21 
21 22 37 37 37 37 37 37 37 37 37 37 37 38 16 17 17 16 37 37 37 37 37 37 37 37 37 37 37 38 20 21 21 21 21 21 
21 22 37 37 37 37 37 37 37 37 37 37 37 37 37 37 37 37 37 37 37 37 37 37 37 37 37 37 37 38 20 21 21 21 21 21 
21 22 37 37 37 37 37 37 37 37 37 37 37 37 37 37 37 37 37 37 37 37 37 37 37 37 37 37 37 38 20 21 21 21 21 21 
21 46 9 9 9 9 9 9 9 9 9 9 9 9 9 9 9 9 9 9 9 9 9 9 9 9 9 9 9 9 45 21 21 21 21 21 
21 21 21 21 21 21 21 21 21 21 21 21 21 21 21 21 21 21 21 21 21 21 21 21 21 21 21 21 21 21 21 21 21 21 21 21 
21 21 21 21 21 21 21 21 21 21 21 21 21 21 21 21 21 21 21 21 21 21 21 21 21 21 21 21 21 21 21 21 21 21 21 21 
21 21 21 21 21 21 21 21 21 21 21 21 21 21 21 21 21 21 21 21 21 21 21 21 21 21 21 21 21 21 21 21 21 21 21 21 
21 21 21 21 21 21 21 21 21 21 21 21 21 21 21 21 21 21 21 21 21 21 21 21 21 21 21 21 21 21 21 21 21 21 21 21